2 ,2 ,2 ,2 ,2 ,2 ,2 ,2 ,2 ,2 ,2 ,2 ,2
2 ,11,3 ,8 ,3 ,3 ,3 ,3 ,3 ,3 ,3 ,3 ,2
2 ,1 ,3 ,2 ,2 ,3 ,29,3 ,29,3 ,2 ,2 ,2
2 ,3 ,2 ,2 ,2 ,2 ,2 ,3 ,2 ,2 ,2 ,2 ,2
2 ,3 ,2 ,6 ,6 ,2 ,3 ,3 ,3 ,2 ,3 ,28,2
2 ,3 ,2 ,6 ,3 ,26,3 ,3 ,3 ,26,3 ,3 ,2
2 ,3 ,2 ,2 ,2 ,2 ,3 ,3 ,3 ,2 ,2 ,2 ,2
2 ,3 ,2 ,30,3 ,2 ,3 ,3 ,3 ,2 ,3 ,27,2
2 ,3 ,2 ,3 ,3 ,26,3 ,3 ,3 ,26,3 ,3 ,2
2 ,3 ,2 ,2 ,2 ,2 ,3 ,3 ,3 ,2 ,2 ,2 ,2
2 ,3 ,2 ,13,13,2 ,3 ,3 ,3 ,2 ,3 ,3 ,2
2 ,10,2 ,13,3 ,26,3 ,3 ,3 ,26,3 ,3 ,2
2 ,2 ,2 ,2 ,2 ,2 ,2 ,2 ,2 ,2 ,2 ,2 ,2