2 ,2 ,2 ,2 ,2 ,2 ,2 ,2 ,2 ,2 ,2 ,2 ,2
2 ,10,3 ,18,19,18,3 ,3 ,3 ,3 ,3 ,3 ,2
2 ,2 ,2 ,2 ,2 ,2 ,2 ,2 ,2 ,2 ,2 ,3 ,2
2 ,12,3 ,3 ,9 ,3 ,2 ,14,6 ,3 ,2 ,3 ,2
2 ,3 ,21,3 ,2 ,3 ,2 ,15,12,3 ,2 ,3 ,2
2 ,2 ,9 ,2 ,2 ,3 ,2 ,2 ,2 ,9 ,2 ,3 ,2
2 ,6 ,3 ,3 ,2 ,3 ,9 ,24,17,24,2 ,3 ,2
2 ,3 ,22,3 ,2 ,3 ,2 ,2 ,2 ,2 ,2 ,3 ,2
2 ,2 ,9 ,2 ,2 ,3 ,3 ,3 ,3 ,3 ,3 ,3 ,2
2 ,3 ,3 ,3 ,2 ,2 ,9 ,2 ,2 ,2 ,9 ,2 ,2
2 ,12,3 ,6 ,2 ,6 ,3 ,3 ,2 ,3 ,24,3 ,2
2 ,12,3 ,6 ,2 ,3 ,1 ,3 ,2 ,18,12,18,2
2 ,2 ,2 ,2 ,2 ,2 ,2 ,2 ,2 ,2 ,2 ,2 ,2