2 ,2 ,2 ,2 ,2 ,2 ,2 ,2 ,2 ,2 ,2 ,2 ,2 ,
2 ,10,3 ,3 ,3 ,3 ,3 ,3 ,3 ,3 ,3 ,3 ,2 ,
2 ,2 ,2 ,2 ,2 ,2 ,2 ,2 ,2 ,2 ,2 ,3 ,2 ,
2 ,3 ,3 ,3 ,3 ,3 ,2 ,3 ,3 ,3 ,2 ,3 ,2 ,
2 ,3 ,21,3 ,2 ,3 ,2 ,3 ,3 ,3 ,2 ,3 ,2 ,
2 ,2 ,9 ,2 ,2 ,3 ,2 ,2 ,2 ,3 ,2 ,3 ,2 ,
2 ,6 ,3 ,3 ,2 ,3 ,3 ,3 ,3 ,3 ,2 ,3 ,2 ,
2 ,3 ,22,3 ,2 ,3 ,2 ,2 ,2 ,2 ,2 ,3 ,2 ,
2 ,2 ,9 ,2 ,2 ,3 ,1 ,3 ,3 ,3 ,3 ,3 ,2 ,
2 ,3 ,3 ,3 ,2 ,2 ,3 ,2 ,2 ,2 ,3 ,2 ,2 ,
2 ,12,3 ,6 ,2 ,3 ,3 ,3 ,2 ,3 ,3 ,3 ,2 ,
2 ,12,3 ,6 ,2 ,3 ,3 ,3 ,2 ,3 ,3 ,3 ,2 ,
2 ,2 ,2 ,2 ,2 ,2 ,2 ,2 ,2 ,2 ,2 ,2 ,2 ,
